Bob	CA
Steve	CA
Andy	TX
Sherry	TX
Silvia	TX
Cynthia	TX
Tex	TX
Alvin	TX
Nate	LA
Jerry	TX
Doug	TX
Terry	CA
Betty	TX
Bertha	TX
Walter	TX
Gus	TX
Jesse	CA
Lydia	TX
Hank	TX
Marie	TX
Fen	IL
Mike	TX
Jack	CA
Ben	TX
Ian	NY
Sarah	TX
Charles	MO
Tom	MO
Mirko	CO
Ted	OH
Kaufman	MA
Andrew	MA
